########################################
#P.....................................#
#......................................#
#......................................#
#........###############...............#
#........#~~~~~~M~~~~~~#...............#
#........#~~~~~~~~~~~~~#...............#
#........#~~~~~~~~~~~~~#...............#
#........#~~~~~~~~~~~~~#...............#
#........######BBB######...............#
#......................................#
#......................................#
#.................E....................#
#......................................#
#......................................#
#......................................#
#......................................#
#......................................#
#......................................#
#......................................#
#......................................#
########################################